   #####
###    #
#.@*   #
### * .#
#.##*  #
# # .  ##
#*  P**.#
#   .   #
#########
